2 5 5 0
#####
#S# #
# # #
#D#G#
#####

#####
#  U#
# ###
#  ##
#####
