4 10 10 10
##########
#S###    #
#   # ####
### # #D##
#   # # ##
#D# # # ##
###    M##
### ### ##
###     ##
##########

##########
#   #   D#
#     ####
###   # ##
#U#   #M##
# #    D##
##########
#       ##
#D# #U# ##
##########

##########
#        #
# ########
# #U     #
# #M     #
# ####   #
#    #####
#### ##U##
# D#    ##
##########

##########
#        #
# ###### #
# #    # #
# # ## # #
# #  #   #
# ##U# # #
# ##M  #M#
#  #####G#
##########
