4 10 10 0
##########
#S###....#
#...#.####
###.#.#D##
#...#.#.##
#D#.#.#.##
###.....##
###.###.##
###.....##
##########

##########
#...#...D#
#.....####
###...#.##
#U#...#.##
#.#....D##
##########
#.......##
#D#.#U#.##
##########

##########
#........#
#.########
#.#U.....#
#.#......#
#.####...#
#....#####
####.##U##
#.D#....##
##########

##########
#........#
#.######.#
#.#....#.#
#.#.##.#.#
#.#..#...#
#.##U#.#.#
#.##...#.#
#..#####G#
##########
