4 10 10 10
##########
#S###....#
#...#.####
###.#.#d##
#...#.#.##
#d#.#.#.##
###....m##
###.###.##
###.....##
##########

##########
#...#...d#
#.....####
###...#.##
#u#...#m##
#.#....d##
##########
#.......##
#d#.#u#.##
##########

##########
#........#
#.########
#.#u.....#
#.#m.....#
#.####...#
#....#####
####.##u##
#.d#....##
##########

##########
#........#
#.######.#
#.#....#.#
#.#.##.#.#
#.#..#...#
#.##u#.#.#
#.##m..#m#
#..#####G#
##########
