2 5 5 0
#####
#S#.#
#.#.#
#d#G#
#####

#####
#..u#
#.###
#..##
#####
